------PHPHHHHHHHHHP-
---PHHPFV---------PP
---V-C--V----------V
PHHP----V---B------V
V-B-PHHHPHHHHHP----P
VB--Sx------E------D
V-B-PHHHPHHHHHP----P
PHHP----V---B------V
---V-C--V----------V
---PHHPFV----------V
------PHPHHHHHHHHHP-
--------------------